开水	白开水
温水	温开水
饮用水	纯净水
凉白开	凉水
清水	纯净水
黑胡椒碎	研磨黑胡椒	
现磨胡椒	现磨黑胡椒	
现磨黑胡椒	研磨黑胡椒	
鸡蛋清	鸡蛋白	
蛋白	鸡蛋液
蛋白	鸡蛋白
蛋白	鸡蛋清
番茄	西红柿
桃	圆桃子
红辣椒	红椒
辣椒油	红油
芝麻油	麻油
地瓜	红薯
地瓜	番薯
胡萝卜	红萝卜
红皮梨	红梨
雪梨	雪花梨
白醋	白米醋
米醋	白米醋
八角	大料
玉米	甜玉米
红酒	红葡萄酒
米酒	甜米酒
马铃薯	土豆
大虾	对虾
即食燕麦	快熟燕麦片
内酯豆腐	内脂豆腐
牛奶	普通牛奶
纯牛奶	牛奶
普通牛奶	纯牛奶
十三香	13香
木薯粉	地瓜粉
嫩肉粉	木薯粉
地瓜粉	嫩肉粉
青芥辣	绿芥末
雪耳	银耳